F 220,100,0
C 225,30,0
NO ./includes/assets/north.xpm
SO ./includes/assets/south.xpm
WE ./includes/assets/west.xpm
EA ./includes/assets/east.xpm

1111111111111111111111111
1000000000110000000000001
1011000001110000000000001
1001000000000000000000N011111111
111111111011000001110000000000001
100000000011000001110111111111111
11110111111111011100000010001
11110111111111011101010010001
11000000110101011100000010001
11000000000000001100000010001
10100000000000001101010010001
1000000111010101111101111000111
11110111 1110101 101111010001
11111111 1111111 111111111111

